R 960 540

NO textures/pengsoo6.xpm
SO textures/pengsoo.xpm
WE textures/pengsoo3.xpm
EA textures/pengsoo5.xpm

S textures/penguin.xpm
F 240,255,255
C 255,153,153

        1111111111111111111111111
        1000000000110000000000001
        1011003001110000000000001
        10010000000000S0000300001
111111111011000001110000000000001
100003000011000001110111111111111
11110111101111011100000010001
11110111111111011101010010001
11000000110101011100000200001
10000000000000001100000000001
10003000000000001101010010001
1100000111010101110001111030111
11110111 1110101 101111110001
11111111 1111111 111111111111
